11 10
##123#####    
#.yXZ....#    
#........#    
#...p....#    
#........#    
#........#    
#........#    
#bwqLP...#    
#VVVVVVVV#    
##########    